das Brot - bread
das Fruhstuck - breakfast
das Obst - fruits
der Kase - cheese
das Ei - egg
der Fisch - fish
die Gabel - fork
die Suppe - soup
der Pilz - mushroom
das Messer - knife
die Zitrone - lemon
das Fleisch - meat
der Loffel - spoon
der Zucker - sugar
der Salat - salad
der Mandel - almond
der Speck - bacon
die Butter - butter
die Erdnuss - peanut
die Kokosnuss - coconut
der Schinken - ham
der Hamburger - hamburger
die Haselnuss - hazelnut
der Hotdog - hotdog
die Nudeln - pasta
die Pistazie - pistachio
der Lachs - salmon
die Wurst - sausage
die Walnuss - walnut
der Jogurt - yogurt